Mission 1
1;2;3;4;5;1;2;3;4;5;1;2;3;4;5;1;2;3;4;5;1;2;3;4;5;1;2;3;4;5;1;2
1;2;3;4;5;1;2;3;4;5;1;20;3;4;5;1;2;3;4;5;1;2;3;4;5;1;2;3;4;5;1;2
1;2;3;4;5;1;2;3;4;5;1;20;3;4;5;1;2;3;4;5;1;2;3;4;5;1;2;3;4;5;1;2
1;2;3;4;5;1;2;3;4;5;1;2;3;4;5;1;2;3;4;5;1;2;3;4;5;1;2;3;4;5;1;2
1;2;3;4;5;1;2;3;4;5;1;2;3;4;5;1;2;3;4;5;1;2;3;4;5;1;2;3;4;5;1;2
1;2;3;4;5;1;2;3;4;5;1;2;3;4;5;1;2;3;4;5;1;2;3;4;5;1;2;3;4;5;1;2
1;2;3;4;5;1;2;3;4;5;1;2;3;4;5;1;2;3;4;5;1;2;3;4;5;1;2;3;4;5;1;2
1;2;3;4;5;1;2;3;4;5;1;2;3;4;5;1;2;3;4;5;1;2;3;4;5;1;2;3;4;5;1;2
1;2;3;4;5;1;2;3;4;5;1;2;3;4;5;1;2;3;4;5;1;2;3;4;5;1;2;3;4;5;1;2
1;2;3;4;5;1;2;3;4;5;1;2;3;4;5;1;2;3;4;5;1;2;3;4;5;1;2;3;4;5;1;2
1;2;3;4;5;1;2;3;4;5;1;2;3;4;5;1;2;3;4;5;1;2;3;4;5;1;2;3;4;5;1;2
1;2;3;4;5;1;2;3;4;5;1;2;3;4;5;1;2;3;4;5;1;2;3;4;5;1;2;3;4;5;1;2
1;2;3;4;5;1;2;3;4;5;1;2;3;4;5;1;2;3;4;5;1;2;3;4;5;1;2;3;4;5;1;2
1;2;3;4;5;1;2;3;4;5;1;2;3;4;5;1;2;3;4;5;1;2;3;4;5;1;2;3;4;5;1;2
1;2;3;4;5;1;2;3;4;5;1;2;3;4;5;1;2;3;4;5;1;2;3;4;5;1;2;3;4;5;1;2
1;2;3;4;5;1;2;3;4;5;1;2;3;4;5;1;2;3;4;5;1;2;3;4;5;1;2;3;4;5;1;2
1;2;3;4;5;1;2;3;4;5;1;2;3;4;5;1;2;3;4;5;1;2;3;4;5;1;2;3;4;5;1;2
1;2;3;4;5;1;2;3;4;5;1;2;3;4;5;1;2;3;4;5;1;2;3;4;5;1;2;3;4;5;1;2
1;2;3;4;5;1;2;3;4;5;1;2;3;4;5;1;2;3;4;5;1;2;3;4;5;1;2;3;4;5;1;2
1;2;3;4;5;1;2;3;4;5;1;2;3;4;5;1;2;3;4;5;1;2;30;4;5;1;2;3;4;5;1;2
1;2;3;4;5;1;2;3;4;5;1;2;3;4;5;1;2;3;4;5;1;2;30;4;5;1;2;3;4;5;1;2
1;2;3;4;5;1;2;3;4;5;1;2;3;4;5;1;2;3;4;5;1;2;30;4;5;1;2;3;4;5;1;2
1;2;3;4;5;1;2;3;4;5;1;2;3;4;5;1;2;3;4;5;1;2;30;4;5;1;2;3;4;5;1;2
1;2;3;4;5;1;2;3;4;5;1;2;3;4;5;1;2;3;4;5;1;2;3;4;5;1;2;3;4;5;1;2
3;1;1
4;2;2
4;2;2
--
Mission 2
1;2;3;4;5;1;2;3;4;5;1;2;3;4;5;1;2;3;4;5;1;2;3;4;5;1;2;3;4;5;1;2
1;2;3;4;5;1;2;3;4;5;1;2;3;4;5;1;2;3;4;5;1;2;3;4;5;1;2;3;4;5;1;2
1;2;3;4;5;1;2;3;4;5;1;2;3;4;5;1;2;3;4;5;1;2;3;4;5;1;2;3;4;5;1;2
1;2;3;4;5;1;2;3;4;5;1;2;3;40;5;1;2;3;4;5;1;2;3;4;5;1;2;3;4;5;1;2
1;2;3;4;5;1;2;3;4;5;1;2;3;40;5;1;2;3;4;5;1;2;3;4;5;1;2;3;4;5;1;2
1;2;3;4;5;1;2;3;4;5;1;2;3;40;5;1;2;3;4;5;1;2;3;4;5;1;2;3;4;5;1;2
1;2;3;4;5;1;2;3;4;5;1;2;3;40;5;1;2;3;4;5;1;2;3;4;5;1;2;3;4;5;1;2
1;2;3;4;5;1;2;3;4;5;1;2;3;40;5;1;2;3;4;5;1;2;3;4;5;1;2;3;4;5;1;2
1;2;3;4;5;1;2;3;4;5;1;2;3;4;5;1;2;3;4;5;1;2;3;4;5;1;2;3;4;5;1;2
1;2;3;4;5;1;2;3;4;5;1;2;3;4;5;1;2;3;4;5;1;2;3;4;5;1;2;3;4;5;1;2
1;2;3;4;5;1;2;3;4;5;1;2;3;4;5;1;2;3;4;5;1;2;3;4;5;1;2;3;4;5;1;2
1;2;3;4;5;1;2;3;4;5;1;2;3;4;5;1;2;3;4;5;1;2;3;4;5;1;2;3;4;5;1;2
1;2;3;4;5;1;2;3;4;5;1;2;3;4;5;1;2;3;4;5;1;2;3;4;5;1;2;3;4;5;1;2
1;2;3;4;5;1;2;3;4;5;1;2;3;4;5;1;2;3;4;5;1;2;3;4;5;1;2;3;4;5;1;2
1;2;3;4;5;1;2;3;4;5;1;2;3;4;5;1;2;3;4;5;1;2;3;4;5;1;2;3;4;5;1;2
1;2;3;4;5;1;2;3;4;5;1;2;3;4;5;1;2;3;4;5;1;2;3;4;5;1;2;3;4;5;1;2
1;2;3;4;5;1;2;3;4;5;1;2;3;4;5;1;2;3;4;5;1;2;3;4;5;1;2;3;4;5;1;2
1;2;3;4;5;1;2;3;4;5;1;2;3;4;5;1;2;3;4;5;1;2;3;4;5;1;2;3;4;5;1;2
1;2;3;4;5;1;2;3;4;5;1;2;3;4;5;1;2;3;4;5;1;2;3;4;5;1;2;3;4;5;1;2
1;2;3;4;5;1;2;3;4;5;1;2;3;4;5;1;2;3;4;5;1;2;3;4;5;1;2;3;4;5;1;2
1;2;3;4;5;1;2;3;4;5;1;2;3;4;5;1;2;3;4;5;1;2;3;4;5;1;2;3;4;5;1;2
1;2;3;4;5;1;2;3;4;5;1;2;3;4;5;1;2;3;4;5;1;2;3;4;5;1;2;3;4;5;1;2
1;2;3;4;5;1;2;3;4;5;1;2;3;4;5;1;2;3;4;5;1;2;3;4;5;1;2;3;4;5;1;2
1;2;3;4;5;1;2;3;4;5;1;2;3;4;5;1;2;3;4;5;1;2;3;4;5;1;2;3;4;5;1;2
3;1;1
4;2;2
4;2;2
4;2;2
4;2;2
--