Mission 1 Testlevel
1;1;1;1;1;1;1;1;13;49;49;49;49;49;49;49;49;14;1;1;1;1;1;1;1;1;1;1;1;1;1;1
1;481;493;493;493;482;1;1;28;517;517;517;517;385;389;529;385;26;1;1;1;1;1;1;1;1;1;1;1;1;1;1
1;496;169;505;505;494;397;397;85;517;517;517;517;517;517;517;517;26;1;1;1;133;145;145;134;1;1;1;1;1;1;1
1;496;505;505;505;494;397;397;85;517;517;517;517;517;517;517;517;26;1;1;1;148;157;157;146;1;1;1;1;1;1;1
1;484;495;495;495;483;1;1;28;517;517;517;517;517;517;517;517;26;1;1;1;136;147;147;135;1;1;1;1;1;1;1
1;1;1;1;1;1;1;1;16;27;27;27;27;85;27;27;27;15;1;1;1;1;1;1;1;1;1;1;1;1;1;1
1;1;1;1;1;1;1;1;1;289;349;349;325;85;313;349;301;1;1;1;1;1;1;1;1;1;1;1;1;1;1;1
1;1;1;1;1;1;1;1;1;337;517;517;517;517;517;517;337;1;1;1;1;1;1;1;1;1;1;1;1;1;1;1
1;229;1;1;1;1;1;1;1;337;517;517;517;517;517;517;337;1;1;1;1;1;1;1;1;1;1;1;1;1;1;1
1;1;1;1;1;1;1;1;1;337;517;517;517;517;517;517;337;1;1;1;1;1;1;1;1;1;1;1;1;1;1;1
1;1;1;1;1;1;1;1;1;313;349;349;349;553;349;349;325;1;1;1;1;1;1;1;1;1;1;1;1;1;1;1
1;1;1;1;1;1;1;1;1;376;577;589;577;589;577;589;374;1;1;1;1;1;1;1;1;1;1;1;1;1;1;1
1;1;1;1;1;1;1;1;1;376;577;589;577;589;577;589;374;1;1;1;1;1;1;1;1;1;1;1;1;1;1;1
1;1;1;1;1;1;1;1;1;376;577;589;577;589;577;589;374;1;1;1;1;1;1;1;1;1;1;1;1;1;1;1
1;1;1;1;1;1;1;1;1;376;577;589;577;589;577;589;378;1;1;1;1;1;1;1;1;1;1;1;1;1;1;1
1;1;1;1;1;1;1;1;1;369;381;381;381;381;381;381;363;1;1;1;1;1;1;1;1;1;1;1;1;1;1;1
1;1;1;1;1;1;1;1;1;1;1;1;1;1;1;1;1;1;1;1;1;1;1;1;1;1;1;1;1;1;1;1
1;1;1;1;1;1;1;1;1;1;1;1;1;1;1;1;1;1;1;1;1;1;1;1;1;1;1;1;1;1;1;1
1;1;1;1;1;1;1;1;1;1;1;1;1;1;1;1;1;1;1;1;1;1;1;1;1;1;1;1;1;1;1;1
1;1;1;1;1;1;1;1;1;1;1;1;1;1;1;1;1;1;1;1;1;1;1;1;1;1;1;1;1;1;1;1
1;1;1;1;1;1;1;1;1;1;1;1;1;1;1;1;1;1;1;1;1;1;1;1;1;1;1;1;1;1;1;1
1;1;1;1;1;1;1;1;1;1;1;1;1;1;1;1;1;1;1;1;1;1;1;1;1;1;1;1;1;1;1;1
1;1;1;1;1;1;1;1;1;1;1;1;1;1;1;1;1;1;1;1;1;1;1;1;1;1;1;1;1;1;1;1
1;1;1;1;1;1;1;1;1;1;1;1;1;1;1;1;1;1;1;1;1;1;1;1;1;1;1;1;1;1;1;1
1;9;1;You shall not pass
0;3;4;Default Text
1;10;1;You shall not pass
1;11;1;You shall not pass
1;12;1;You shall not pass
1;13;1;You shall not pass
1;14;1;You shall not pass
1;15;1;You shall not pass
1;16;1;You shall not pass
1;17;1;You shall not pass
1;18;1;You shall not pass
1;18;2;You shall not pass
1;9;2;You shall not pass
1;9;5;You shall not pass
1;9;6;You shall not pass
1;10;6;You shall not pass
1;11;6;You shall not pass
1;12;6;You shall not pass
1;13;6;You shall not pass
1;15;6;You shall not pass
1;16;6;You shall not pass
1;17;6;You shall not pass
1;18;3;You shall not pass
1;18;4;You shall not pass
1;18;5;You shall not pass
1;18;6;You shall not pass
1;13;7;You shall not pass
1;12;7;You shall not pass
1;11;7;You shall not pass
1;10;7;You shall not pass
1;15;7;You shall not pass
1;16;7;You shall not pass
1;17;7;You shall not pass
1;10;8;You shall not pass
1;17;8;You shall not pass
1;17;9;You shall not pass
1;10;9;You shall not pass
1;17;10;You shall not pass
1;10;10;You shall not pass
1;10;11;You shall not pass
1;17;11;You shall not pass
1;11;11;You shall not pass
1;12;11;You shall not pass
1;13;11;You shall not pass
1;15;11;You shall not pass
1;16;11;You shall not pass
1;16;11;You shall not pass
2;16;2;Hacking
1;3;3;Hallo team!
--
newlevel
1;1;1;1;1;1;1;1;1;1;1;1;1;1;1;1;1;1;1;1;1;1;1;1;1;1;1;1;1;1;1;1
1;1;1;1;1;1;1;1;1;1;1;1;1;1;1;1;1;1;1;1;1;1;1;1;1;1;1;1;1;1;1;1
1;1;1;1;1;1;1;1;1;1;1;1;1;1;1;1;1;1;1;1;1;1;1;1;1;1;1;1;1;1;1;1
1;1;1;1;1;1;1;1;1;1;1;1;1;1;1;1;1;1;1;1;1;1;1;1;1;1;1;1;1;1;1;1
1;1;1;1;1;1;1;1;1;1;1;1;1;1;1;1;1;1;1;1;1;1;1;1;1;1;1;1;1;1;1;1
1;1;1;1;1;1;1;1;1;1;1;1;1;1;1;1;1;1;1;1;1;1;1;1;1;1;1;1;1;1;1;1
1;1;1;1;1;1;1;1;1;1;1;1;1;1;1;1;1;1;1;1;1;1;1;1;1;1;1;1;1;1;1;1
1;1;1;1;1;1;1;1;1;1;1;1;1;1;1;1;1;1;1;1;1;1;1;1;1;1;1;1;1;1;1;1
1;1;1;1;1;1;1;1;1;1;1;1;1;1;1;1;1;1;1;1;1;1;1;1;1;1;1;1;1;1;1;1
1;1;1;1;1;1;1;1;1;1;1;1;1;1;1;1;1;1;1;1;1;1;1;1;1;1;1;1;1;1;1;1
1;1;1;1;1;1;1;1;1;1;1;1;1;1;1;1;1;1;1;1;1;1;1;1;1;1;1;1;1;1;1;1
1;1;1;1;1;1;1;1;1;1;1;1;1;1;1;1;1;1;1;1;1;1;1;1;1;1;1;1;1;1;1;1
1;1;1;1;1;1;1;1;1;1;1;1;1;1;1;1;1;1;1;1;1;1;1;1;1;1;1;1;1;1;1;1
1;1;1;1;1;1;1;1;1;1;1;1;1;1;1;1;1;1;1;1;1;1;1;1;1;1;1;1;1;1;1;1
1;1;1;1;1;1;1;1;1;1;1;1;1;1;1;1;1;1;1;1;1;1;1;1;1;1;1;1;1;1;1;1
1;1;1;1;1;1;1;1;1;1;1;1;1;1;1;1;1;1;1;1;1;1;1;1;1;1;1;1;1;1;1;1
1;1;1;1;1;1;1;1;1;1;1;1;1;1;1;1;1;1;1;1;1;1;1;1;1;1;1;1;1;1;1;1
1;1;1;1;1;1;1;1;1;1;1;1;1;1;1;1;1;1;1;1;1;1;1;1;1;1;1;1;1;1;1;1
1;1;1;1;1;1;1;1;1;1;1;1;1;1;1;1;1;1;1;1;1;1;1;1;1;1;1;1;1;1;1;1
1;1;1;1;1;1;1;1;1;1;1;1;1;1;1;1;1;1;1;1;1;1;1;1;1;1;1;1;1;1;1;1
1;1;1;1;1;1;1;1;1;1;1;1;1;1;1;1;1;1;1;1;1;1;1;1;1;1;1;1;1;1;1;1
1;1;1;1;1;1;1;1;1;1;1;1;1;1;1;1;1;1;1;1;1;1;1;1;1;1;1;1;1;1;1;1
1;1;1;1;1;1;1;1;1;1;1;1;1;1;1;1;1;1;1;1;1;1;1;1;1;1;1;1;1;1;1;1
1;1;1;1;1;1;1;1;1;1;1;1;1;1;1;1;1;1;1;1;1;1;1;1;1;1;1;1;1;1;1;1
--
